the_look	album
circus	magazine
origo	album
methana	peninsula
aesthetics	philosophy
nova	album
elvis	film
bustard	species
encantado	album
nola	film
soundelux	company
cogniview	company
mutilation	album
darkness	book
don_quixote	film
biswaprakash	film
peacock	species
subway	album
affinity	film
panorama	work
modulate	album
moose_creek	river
appsense	company
quest	film
metal	album
brigadoon	film
tottenham	town
ashfield	hamlet
wheel	force
haircut	film
nonino	company
kiss	book
badfinger	album
grand_prix	film
fiat	company
tesco	company
the_killers	album
starstruck	film
dereham	town
thulabharam	film
score	film
the_fame	album
strays	film
symbol	sign
anuraag	film
ugetsu	film
the_message	book
idjwi	island
babs	film
liuhe	town
fissures	film
immortal	book
ruby	single
burrda	company
black	single
orca	company
alpinist	magazine
starship	film
f.t.t.w.	album
pulmonary	disease
urdu	language
downtown	film
himself	album
chiller	machine
ithaca	town
sana	river
kadhalan	film
hammerson	company
number	company
skagerrak	film
film	magazine
interface	surface
quindim	dessert
hijack	album
empty	album
nephrosis	nephropathy
promises	work
drillbit	film
maureen_mcgovern	album
ansaldobreda	company
cataract	falls
dookie	album
spanish	language
kolya	film
roadkill	film
neurotensin	protein
tiger	film
hydra	film
explorers	film
aurora	opera
jupiter	work
explorer	album
ailette	river
finger	album
project	person
vega	star
diversity	album
marquette	town
camelford	town
sherwood	town
saucy	album
those_things	album
ambidextrous	book
keswick	town
internship	post
amazon	film
veeranjaneya	film
pesa	river
peebles	town
diwan	album
honeymoon	work
canna	island
vils	river
metamorphosis	film
sanborn	town
whitewood	town
abucea	river
date	single
skeleton	album
aviv	film
the_cat	film
venice	film
orthodoxy	book
nina	film
sinners	film
shutter	film
lita	album
macgruber	film
linger	album
allied	company
serpens	constellation
september	single
comet	book
obesity	disease
l.m.l.	album
pods	company
dreddup	album
rank	album
buet	university
wilson	episode
villains	album
transition	magazine
jyothi	film
laura	album
fireworks	episode
images	album
isle	river
seacoal	film
tifosi	film
quintessence	album
mentor	film
doctorate	university
distrigas	company
the_lost_tapes	album
paulus	person
blacksummers'night	album
borderland	work
family	collection
seedlings	film
troy	town
suicidal_tendencies	album
alliances	episode
hush	film
nic_jones	album
ashirbad	album
nunaoil	company
liebestraum	film
azhuthayar	river
mike	agent
phasmid	insect
buzzard	hawk
hispanic	american
suvasvesi	lake
situation	single
the_law	book
patience	opera
ecosoc	council
lullaby	episode
anahat	film
nukukehe	album
tamanna	film
moneysense	magazine
nordovyy	island
jennings	work
roja	film
shuikou	town
clade	taxon
linkedin	company
daktronics	company
discosis	album
the_parent_trap	film
writing	work
chesham	town
kaon	meson
bratsigovo	town
ring	chain
erickson	town
angelica	town
marken	peninsula
rioni	river
windows	album
record	list
kemistry	album
dungen	album
ahmed	film
freelance	film
these_days	album
error	misconception
evermore	book
unison	album
ricky_nelson	album
research_center	institute
walferdange	town
ittefaq	film
healthways	company
perkinsus	species
cairo	library
stalker	album
copycat	film
negros	island
baldur	album
cerise	color
down	album
dianra	town
odra	river
dixie	album
dinocroc	film
absurd	film
krazana	film
reverence	album
weqaya	company
supermarket	album
porthole	window
drac	river
death	property
next	work
secret	film
born	work
savage	album
icebreaker	book
spinners	album
fluff	stuff
krumovgrad	town
finisterra	album
unicredit	company
hysterics	album
noon	magazine
amandus	film
coendou	species
tosca	album
gadolinium	metal
davidson	settlement
tura	settlement
disengagement	film
victim	work
metropolitan	work
dreamworks	company
vogtlandbahn	company
english	album
el_mariachi	film
zero	film
perinjankutti	river
patrick	film
the_lemonheads	album
corticon	company
services	work
furzehill	hamlet
euler	person
temporal	album
lush	work
bonneville	film
chavakachcheri	town
m@rix	album
shochiku	company
uhabia	river
arumugam	film
friendship	relationship
feet	agent
slush	album
maze	single
dedication	album
updata	company
inquilaab	album
softwood	company
chiers	river
chattahoochee	single
casino	film
gampola	town
kola	peninsula
silt	soil
satori	enlightenment
the_messenger	film
judex	film
smile	book
murderer	killer
emerson	town
the_power	album
rearguard	detachment
anjali	person
monk	album
barbarossa	film
butter	film
philosophy	album
spring	subsidiary
athos	album
spyker	company
shatu	town
root	agent
boogeyman	film
nellymoser	company
umzinto	town
mudlark	album
coolamon	town
minnie	album
the_poseidon_adventure	film
sundown	album
blade	magazine
humboldt_county	film
flag	list
chitralekha	film
energy_orchard	album
painter	agent
australopithecine	hominid
botany	biology
macromedia	company
scorpia	book
toivakka	municipality
sport	activity
accountant	person
brundavanam	film
delaware	album
spui	square
numbers	album
aristotle	painting
innovation	album
keystone	town
rapture	album
stolen	film
undercurrent	film
flee	album
logic	principle
wheaton_college	university
razzle	magazine
apocrypha	episode
pandiyan	film
all_about_you	film
elizabeth	film
lathraea	species
reynolds	agent
cyracom	company
alberto	athlete
the_giant	album
buya	language
krull	film
fuji	film
skyline	album
betrayed	film
phase	person
syntex	company
torrent	film
swsoft	company
veta	film
work	activity
dharampur	town
norton	suburb
addiction	work
abort	film
river	single
holly	film
affinity	agent
mediocre	album
nandu	film
gremlins	film
amgen	company
browns	company
the_truth	film
batch	collection
st_edmund_hall	university
draft	person
asset	spaceplane
boulder	stone
cable	work
crawdaddy	album
shondaland	company
parthenon	temple
stars	single
guanqiao	town
octopussy	film
delal	bridge
kanchivaram	film
hotel	film
halle	work
the_town	album
allegiance	film
track	groove
theropod	species
stony_stratford	town
frog	album
abadan	film
padatik	film
corwin	film
hartlepool	town
representation	activity
redding	town
jerk	album
bonobos	company
slumming	film
pearl	album
javier	athlete
heppenheim	town
dragon	book
barton	constituency
hiawatha	film
unforgettable	album
the_professional	film
scrapper	film
john_fogerty	album
mobile_bay	river
rzav	river
petnja	lake
pagliacci	film
century	single
lelepa	island
the_hard_way	album
pagoda	album
exploration	expedition
trio	work
dtek	company
beni	album
limmat	river
link	human
amorino	album
person	album
tangerine	color
melodies	album
boardwalk	film
model	representation
aube	river
zagyva	river
klim	company
claudius	person
doppelganger	film
return	movement
nassau	island
innerspace	film
titanic	restaurant
bomber	film
deadfall	film
human	film
journey	film
movement	change
vinci	company
atrocities	album
getronics	company
orix	company
orthoclase	feldspar
r.s.v.p.	album
haunted	album
the_state	book
greenville	town
mammoth	film
viscose	rayon
agonist	drug
kocherinovo	town
salcombe	town
distancia	album
wadena	town
score	evaluation
ambev	company
leigh	actress
adulthood	film
mega	album
codra	company
telestream	company
meaning	thought
cultivar	variety
extraction	work
flytrap	album
the_next_three_days	film
aura	book
sprint_corporation	company
telecable	company
kongo	film
traps	film
lidice	film
weed	album
blink-182	album
satyr	film
zwingenberg	town
frei	album
union_institute	university
indiana	album
perimeter	length
cotton	album
sidney	book
kingsteignton	town
wilson	agent
brazeau	town
prince	human
fear	film
nbty	company
nstar	company
buddha	person
born	album
boris_godunov	opera
cassis	species
drew	agent
desire	agent
loft	film
torpedo	armament
scandinavia	peninsula
monologue	album
freezing	manga
boyband	film
judith	book
grafton	company
resident	magazine
springer	agent
tubthumping	single
limited	agent
truecar	company
leucocyte	album
carnies	film
chalice	person
wide_awake	album
middlebury_college	university
effelder	river
wollaston	physicist
haeckel	biologist
vollrath	company
hoist	album
unipetrol	company
illuminations	work
fingerprince	album
bulova	company
inspiration	thought
coseley	town
paka	settlement
barnard	cyclecar
mykines	island
march	advancement
overkill	book
pandora	work
convergence	painting
splash	album
crimson	album
paris	album
rewilding	album
salsa	film
stolpsee	lake
unilever	company
suit	clothing
outbound	album
premium	film
microcosm	museum
john_barrowman	album
offerings	album
edit	album
broken_wings	film
merwede	river
ziegler	chemist
jeppesen	company
necromancer	album
klondike	solitaire
bierbach	river
transmutation	album
timbiriche	album
polladhavan	film
vatos	episode
telenav	company
aayudham	film
vrbas	river
manchester_polytechnic	university
b-52	cocktail
santorini	island
chorley	town
mora	town
billy_elliot	film
roma	airship
ritratti	album
cobham	town
peacock	film
stortorget	square
enesco	company
duke_law_school	university
le_tigre	album
dancing	single
salina	town
osibisa	album
agri	river
serendipity	album
carny	film
japan	work
wyalusing	town
brule	town
vertigo	album
lead	score
chorea	disease
wilson	town
fears	album
almeida	town
lizzie	film
australian_english	language
burgundy	color
kioa	island
bebelplatz	square
niit	company
vidocq	film
postoloprty	town
extrapolation	album
emerge	magazine
ragtime	book
roberta_flack	album
dewey	town
picnic	film
explosion	film
gorgopotamos	river
ruby	book
icon	company
kihnu	island
rick	film
effect	symptom
hamina	town
linzi	town
chips	film
bridesmaids	film
manga	company
muthassi	film
valod	town
springfield	settlement
collaboration	album
lexmark	company
rudraksh	film
aion	album
ludlow	town
wittow	peninsula
amrit	film
monitor	company
renditions	album
blackbook	magazine
strategy+business	magazine
ethos	magazine
rome	leaders
ukulhas	island
reconstruction	interpretation
bazalt	company
theofilos	film
penance	sacrament
chaitali	film
tint	magazine
cozumel	island
daughters	work
rodent	species
ectopia	album
visual	album
strongroom	film
buchenwald	album
crossroads	episode
eysenck	psychologist
the_bottom	town
touchstone	album
morse	town
suicide	album
logos	album
walk	career
emir	film
madhouse	film
brettach	river
stage	company
ruhnu	island
king	chessman
pinchbeck	alloy
dobele	town
agonia	film
encore	album
triouzoune	river
kartavya	film
rust	color
warhol	painter
stars	agent
sandbar	river
election	book
reservoir_dogs	film
voodoo	film
diogenes	philosopher
michigan	album
gamera	film
camila	film
tremble	film
tammela	municipality
extensions	album
cancer	album
olympia	painting
trace	reference
imagineering	company
atlantic	company
meatballs	film
leave	album
ismail	agent
muzika	album
portraits	album
congo	book
angelo	athlete
taurion	river
cola	album
reebok	company
disclosure	book
lifepod	film
executive	administration
grismer	company
paranoid	film
bethany_college	university
snowmelt	river
pond	lake
caterpillar	film
sinbad	film
staffelsee	lake
reality	single
callcredit	company
caldera	film
oberon	opera
masti	film
surface	album
oddities	album
spector	company
trance	film
spellbound	film
embraer	company
ultra	company
popular_demand	album
surrogates	film
garcia	species
haywire	film
rebel	film
yama	album
recordings	record_label
tarragon	herb
sadhna	film
witness	testimony
soweto	township
engage	album
elmwood	house
chayam	film
vitra	company
atherstone	town
ghela	river
churro	snack
self	album
calculus	pure_mathematics
shoulder	bone
severance	film
veranda	magazine
maulach	river
sebastian	film
epidemic	film
rgd-5	grenade
squamous_cell_carcinoma	skin_cancer
leila	film
breaker	album
humanimal	album
anjaneyulu	film
porkkalam	film
foma	album
towelhead	film
reincarnation	book
essex	model
eddie_money	album
sheba	film
tyrant	album
yogi	person
sandwip	island
jewels	album
barum	company
liberty	town
travelling	album
vigilante	film
light	single
canvas	album
u.f.orb	album
midnight_oil	album
snow_white	film
zabardast	film
leave	permission
prostate_cancer	disease
daredevil	book
topiary	garden
probe	agent
passage	agent
dhund	film
aperture	opening
paltel	company
buffalo	game
the_avengers	film
herbarium	collection
album	film
this_sporting_life	film
parker_brothers	company
windmill	company
salix	species
loewe	company
zambak	magazine
pigment	material
assassin	murderer
canisius_college	university
stacks	album
whittlesey	town
meiko	album
anger	river
jarrett	film
liminka	municipality
scheduling	planning
sublime	film
willamette_industries	company
pink	color
eland	antelope
pamisos	river
lame	album
huehuetenango	municipality
lushootseed	language
jinx	film
caramel	album
ovum	gamete
witchcraft	album
bomaderry	school
petrol	single
reca	protein
khukuri	knife
escalator	clause
gotham	film
gold	yellow
risk/reward	film
the_up_escalator	album
pure	album
marriage	book
remixed	album
tweeter	loudspeaker
manic	film
dravinja	river
hex_enduction_hour	album
ducati	company
hemel_hempstead	town
wixiw	album
patrice	album
execution	album
passages	film
slam	album
tobacco	person
fuel	film
rain	book
havel	river
brewery	plant
hekatonkheires	giants
ticket	list
aida	film
roman	album
struggle	film
nuvasive	company
hulla	film
township	local_government
mulberry	company
closer	book
microsystems	magazine
calumet	town
my_dog_skip	film
seneca	statesman
viceroy	governor
adonara	island
cope	film
engelberg	album
mallika	film
jomala	municipality
shoeshine	film
gudrun	film
bracht	river
heat	album
the_donnas	album
cube	film
release	activity
schizophonic	album
babyteeth	album
kiel	town
ammannia	species
kaashh	film
naseeb	film
the_bible	film
the_ghouls	film
privatbank	company
madison	settlement
bobby	album
tanker	freighter
swades	film
brighouse	town
princess	magazine
ernst	work
inuit	people
birdman	book
rambler	company
borders	settlement
nicastrin	protein
hotell	film
unicamp	university
power	album
the_sweetest_days	album
scat	company
vlasina	river
ilex	species
attra	company
commandos	film
sapphire	film
critters	film
king	album
apple_computer	company
cummins	town
earthworm	album
dave	film
brigadier	soldier
ananda	album
elbow	bend
variation	change
celluloid	film
youthquake	album
graig	settlement
fundamental	album
spin	work
mandrake	episode
champion	single
broadway	hotel
damage	injury
frida	film
suzaku	film
lakeboat	film
heavy	album
uniondale	town
success	company
millennium	book
nepenthes	taxon
island	single
alnwick	town
hawaii	island
signia	company
backbone	album
tomkorp	company
brooklyn	book
orca	film
involvement	connection
alzheimer	film
gaayam	film
royals	single
the_unknown	album
eagles	album
my_song	album
airborne	company
bench	company
kirkby	town
hassam	painter
timeline	book
alive	company
crowland	town
croatia_records	company
grobnik	settlement
webmethods	company
dreamy	album
surveillance	book
bistrica	river
aakraman	film
sounds	magazine
natalia	film
luancheng	town
sacrament	album
trap	album
cassadaga	album
patriots	film
didymoteicho	town
agrofert	company
stingray	film
subaru	company
aria	work
mile	work
hajimemashite	album
gibraltar	town
outburn	magazine
novgorod	settlement
hits	work
sulk	album
frozen	film
descriptor	information
volunteer	album
film	agent
birkelunden	park
drive	episode
section	agent
hardball	film
jonas	film
solidere	company
kitchen	book
aadmi	film
tabiteuea	island
shallcross	house
prunella	film
nightfall	album
blackwoods	film
bourbince	river
comedown	film
hyder	company
altium	company
folkestone	town
gottscheerish	dialect
portrait	agent
paris	settlement
herrensee	lake
biggleswade	town
redenzione	film
circus	album
marius	agent
clandestinos	film
oglio	river
a_hit	single
self	agent
lucifer	agent
balkans	peninsula
phycoerythrin	pigment
baal	album
uyghur	language
seekers	work
gtech	company
shogun	album
koiluoto	island
dytiscidae	species
eshop	company
t.o.p	album
flowers	magazine
wintersun	album
wyhra	river
lombards	tribe
flour	agent
fresenius	company
madness	album
eton_college	university
fatima	film
nevada_state_bank	subsidiary
souvenir	film
basant	film
ventnor	town
bass	agent
silverado	film
malayalam	language
stampede	album
background	panorama
kolubara	river
thegn	person
garbo	film
shake/shiver/moan	album
circus	company
reincarnation	album
greenwich	town
kaska	language
diva	book
perfume	film
hull	town
equality	sameness
musicdisk	album
prophecy	episode
dark	agent
britannia	company
andover	town
eila	film
plus	company
the_weather	album
washington	person
elena	film
zaman	album
interbank	company
puissance	power
utilitarianism	theory
holi	festival
euterpe	species
frank_black	album
oshkosh	town
an_education	film
urge	desire
tumut	town
wardley	company
stall	film
clay	phyllosilicates
eros	album
titanic	film
salamanca	district
mammoth	elephant
communauto	company
overcomer	album
orleans	work
the_beginning	film
marmoulak	film
underberg	town
mesmer	film
washer	seal
three	film
bleed	film
trindade	island
rossy	person
bala	film
the_singles	album
vevey	town
stellite	alloy
touch	agent
primo	film
rollerball	film
suction	pressure
the_guardian	comedy
aniksi	album
rendition	film
mosley	film
classified	album
desert	album
brasileirinho	film
consequences	film
demosthenes	statesman
radix	number
zembra	island
jiangqiao	town
china	agent
lauwersmeer	lake
lefty	album
fairytales	album
albert_hammond	album
clowns	work
dafu	town
chobani	company
price	worth
rexall	company
ellipse	album
sermon	speech
maelstrom	book
eure	river
37signals	company
declaration	album
ipsos	company
socket	receptacle
rolling	film
comptiq	magazine
new_orleans	film
poses	album
elil	album
the_lighthouse	company
unsolved	album
markandeyan	film
shima	film
rhythm	work
kabo	town
trichechidae	species
customs	agent
equality	work
backlash	reaction
psychedelicatessen	album
the_leader	book
socrates	person
tatweer	company
kippur	film
gotham	album
the_development	album
the_line	film
march	book
orion	book
the_law	album
adelaide	album
orne	river
verwood	town
electronics	physics
works	agent
brca2	protein
natalie	album
the_thomas_hardye_school	academy
letraset	company
cantilena	album
kitchen_princess	manga
the_ride	album
wizard	magazine
honolulu	magazine
eday	island
cinepix	company
tuam	town
kunak	town
free	person
twig	branch
helm	album
hajj	album
vietnam	album
the_killer	film
shalkar	town
carefusion	company
rarities	album
hussain	person
adobe_systems	company
rediffusion	company
module	compartment
ljubljanica	river
conductor	music_director
semele	opera
rieter	company
the_season	work
security	safety
kaltenbach	river
safari	expedition
lagniappe	gift
blinky	film
drag	album
tennessee	single
the_master	book
the_field	film
grain	magazine
saxmundham	town
devdoot	film
aloha	greeting
digit	magazine
imaginaerum	film
daihatsu	company
punches	album
deal	town
pianosa	island
priceless	album
rickshawkaran	film
patchway	town
d'eux	album
shree	film
clutch	album
suzuki	album
death	agent
evolver	album
kholm	settlement
thurmont	town
conservatory	garden
kaveri	film
batak	town
the_switch	film
coarctation	narrowing
curie	physicist
trance	album
shifty	film
italiano	language
not_me	album
solace	film
uppu	film
nitrox	mixture
viscountcy	title
smile	single
burn	book
elaine_paige	album
salina	island
soliloquy	speech
the_magic_numbers	album
southern_sami	language
norfolk	album
burgundians	tribe
kamakiriad	album
charlie	album
leukemia	cancer
rave	film
trip	agent
hawaiian	language
shakespeare	person
stephens	person
kanyakumari	film
trainspotting	book
somali	language
broken	album
morgiana	film
o.s.t.	album
elegant_gypsy	album
nora	film
pikanchi	single
laptop	film
attitude	album
score	album
flexcar	company
pharao	album
leech	person
incunabula	album
kirari	album
atliens	album
manhunt	episode
pine	conifer
dalke	river
all_about_you	album
dubysa	river
trafic	film
alta	company
koncert	film
emery	town
ramsay	house
procycling	magazine
manitou	town
cellular	film
marratech	company
treat	album
the_theme	film
uhuru	work
memory_alpha	wiki
lubbock	album
musiq	album
eucalyptus	album
nebel	river
the_naked_civil_servant	book
telescopium	constellation
the_big_bang	album
stones	film
tuaran	town
scala	work
slim	person
group	company
kingsnake	colubrid
konstantinovka	settlement
praetorians	album
stampede	film
alliedsignal	company
composure	album
intimidation	fear
sumday	album
austromenidia	species
prayer	work
xiaoqiao	town
murderball	film
gunehgar	film
charleston	film
the_climax	film
antagonist	muscle
t.o.p.	album
thing	target
shirin	film
the_anniversary	film
skullduggery	film
toolbox	album
frailty	film
link	film
jasad	magazine
helen	person
lamborghini	company
socialtext	company
aluminum	album
headlights	album
habermann	film
mell	person
eddie	film
rave	dance
barclay	agent
gibeon	meteorite
belief	album
cruise	tourism
mera	river
myjava	town
tundra	biome
christine	book
coronation	film
littlerock	film
housekeeping	book
company	establishment
ossett	town
baruch	book
binary	star
young	beast
citadel	film
pocklington	town
psocodea	species
roya	river
matters	album
oceanic	album
eggs	film
cactus	film
blackfalds	town
alligator	film
achwa	river
otherworld	album
mysteries	book
dakar	album
lichfield	town
anything	work
patita	film
ursa_major	constellation
sheetz	company
vendo	company
abel	album
supernova	explosion
caffaro	river
vaseegara	film
boulder	album
daemon	book
variation	theme
kharas	town
exit	magazine
indigo	company
hungarian	language
andy_warhol	film
voskhod	spacecraft
lakeba	island
bluefin	tuna
balls	film
the_lady	film
cirtas	company
naani	film
intruder	film
allegory	painting
freakshow	film
vengeance	book
tomtom	company
klimt	film
grammatics	album
drive	return
doll	work
burgrave	count
gempak	magazine
linear	album
comeback	album
shilong	town
academy	film
memory	film
vol.2	album
john_jay	chief_justice
darklight	film
beck	manga
rhine	river
festo	company
larrabee	town
josef	film
laddu	dessert
the_love_songs	album
yoruba	language
vishwaroopam	film
sirius_canada	company
daksa	island
metamorpheus	album
unholy	album
sanjuro	film
coefficient	constant
cardston	town
lifeforce	film
marks	agent
lousada	town
mugiboogie	album
kaqchikel	language
stahl	agent
raphia	species
lymington	town
the_dwarf	book
clarington	municipality
grease	work
the_statue	film
berkeley	town
rokeby	house
aristotle	person
firefox	film
glaubeliebetod	album
chamberlain	steward
the_da_vinci_code	film
rome	album
kathanayakudu	film
zebrahead	album
benchmark	reference
humanity	episode
provoke	album
warren	chief_justice
exception	omission
vivo	town
royal_bank	company
tundzha	river
howler	album
joyous	album
contigo	album
dreamgirls	film
western	book
scandalous	album
sodomites	film
scarecrow	supervillain
empis	species
impetus	drive
elen	person
felt	agent
snowball	film
telefon	film
cavalcade	album
outrider	album
antigone	album
playhouse	company
grangemouth	town
game	activity
the_falls	film
anger	album
redwall	book
history	book
romtelecom	company
empedocles	episode
swaham	film
look	work
china	settlement
runners	film
sides	album
midale	town
tomahawk	film
sunzha	river
lemberg	town
voyage	album
cayo	film
retail	trade
imeall	album
vassar_college	university
hartebeest	antelope
hawthorne	book
satisfaction	film
bissell	company
raytheon	company
bismoi	magazine
aeronautical	university
cherish	album
antiprism	polyhedron
catalyst	book
juked	magazine
valga	town
venus	book
scavengers	album
gagamboy	film
pervirella	film
shikotan	island
calling	album
madonna	person
flex	film
the_turning_point	film
skylarks	film
saudi_arabia	monarchy
illusion	album
senna	film
the_script	person
coker_college	university
merlin	magician
geneticist	biologist
roman	work
serious	album
peacock	birds
hysterical	album
alice	film
cheetah	film
mitel	company
xchange	film
pacifism	belief
inishmaan	island
walgreens	company
unconditional	film
protector	film
martha	film
shadowzone	film
forellenbach	river
kingfish	album
trucks	film
lift	layer
steely_dan	album
danainae	species
clemencia	film
broderbund	company
tallahassee	episode
interlopers	book
caramel	candy
alien	agent
savane	album
contest	album
bodyjar	album
guantanamera	film
patience	album
transmutation	change
redball	film
gondwanaland	album
dutchman	film
tollensesee	lake
syllabary	script
douro	river
zelenchukskaya	stanitsa
ecru	color
inheritance	work
deviant	album
avre	river
nerone	film
cape_moreton_light	lighthouse
mediterraneo	film
calla	album
serpentine	album
lepaera	municipality
game	recreation
torque	film
lilith	magazine
gurk	river
automatix	company
hypergiant	star
natta	chemist
romantico	album
delta	film
croceverde	suburb
maserati	company
narromine	town
globacom	company
agora	film
zauberberg	album
muni	film
prevail	album
baldock	town
romanza	album
invisible	film
cain	work
schramm	film
monroe	settlement
houhai	lake
vertigo	film
volts	album
missoula	town
bradley	town
batik	library
zechstein	group
naayak	film
vikhroli	suburb
petrobangla	company
circles	film
affection	album
route	river
them	film
fastest	film
kirundi	language
peoplesoft	company
abominations	album
brotherhood	album
outrage	album
viaur	river
almond	town
pantyhose	tights
quine	philosopher
the_source	person
archive	work
zingst	peninsula
troy	film
fanatic	film
election	vote
meetings	magazine
twinkle	single
pollenia	species
crusoe	film
imprint	album
thief	album
captain	officer
kenneth	person
tokuma	company
zuma	restaurant
estrellas	album
transforce	company
blacksburg	town
phantasm	film
western	agent
silent	language
plus	book
chester	album
cooling	mechanism
monterey	town
thunderstruck	film
lateen	sail
peace	album
the_sheriff	film
qiangma	town
united_devices	company
headmistress	principal
kumudam	magazine
biaroza	town
the_movement	person
m*a*s*h	book
khmer	language
abel	agent
harrison	town
simon	film
genta	company
konkani	language
sussex	county
david_archuleta	album
xuxa	album
mulberry	species
australia	film
hennessy	film
patriots	work
odontobutis	species
eloise	book
the_count	film
wake	book
geeks	film
siren	magazine
thangam	film
look	album
skeletons	work
eucomis	species
cannonball	film
dystopia	fiction
manager	agent
rule	company
forum	magazine
palauan	language
chen	person
raalte	municipality
juice	ingredient
banga	album
mannat	film
islam	religion
giudecca	island
kisses	album
honor	person
saptak	album
columbian_college	university
peterlee	town
bulbocodium	species
syndrome	symptom
singtel	company
dreamwatch	magazine
laugh	album
necroscope	book
game	beast
pleasure	person
manoranjan	film
the_rainbow	book
orthodox	album
elrad	magazine
lace	album
charminar	monument
posey	agent
overkill	album
potato	film
waterloo	film
fluid	matter
rhythm	single
siena	town
david_cassidy	album
suds	film
breakdown	failure
moss	album
discount	person
nicholas	work
east_grinstead	town
rescue	album
alva	settlement
uitenhage	town
flaws	album
dordogne	river
fulda	river
san_jose_state_college	university
kasmodiah	album
icbc	company
economics	social_science
shearwater	album
trowbridge	town
rosanna	single
vulcano	island
granite	rock
vibrate	album
hadfield	town
i.o.u.s.a.	film
jericho	album
kaliyugam	film
ranipur	town
alma	album
driven	album
orbe	river
oranges	film
standard_arabic	language
time	magazine
switchback	film
taal	film
clitheroe	town
booth	store
the_wildhearts	album
dyke	barrier
i.e.m.	album
augustus	person
lanzenbach	river
frostisen	glacier
potpourri	album
risen	album
buber	philosopher
globalenglish	company
varanus	species
changes	film
lenox	town
thunderground	film
meddle	album
bersuit	album
collaborations	album
puerto_rico	album
merantau	film
hythe	town
himalayas	range
cyclo	film
bagley	town
newborn	album
aegon	company
lung_cancer	disease
assassin	agent
principle	value
relentless	film
yuryevets	settlement
labradford	album
diples	dessert
cultivar	plant
wrestlers	painting
seneca	philosopher
youth	work
fedex	company
dreamers	film
window	album
lepus	constellation
sasural	film
anshan	town
merderet	river
zamana	film
uisce	album
jude	film
energy	entity
euterpe	muses
my_time	album
trapeze	album
kristinestad	town
plan	thought
dohwa	company
conquest	success
mattilo_manikyam	film
arch	settlement
mouchette	film
hyatt	company
moloch	film
roseanna	film
palms	album
amar	album
quantang	town
shorts	film
bullet	book
version	interpretation
forth	river
ijjodu	film
ballot	papers
kokborok	language
julie	work
submission	film
infinity	work
avocent	company
windage	drag
tristan	book
kayleigh	single
makin	island
the_apple	film
siebel	company
cloud	group
bridgend	town
destination	terminal
olympia	film
hardenberg	municipality
kupfer	river
magnifico	film
whitman	missionary
torus	album
stand	work
little_brown	company
bend	album
mosaic	album
shishira	film
mack_trucks	subsidiary
mathilde	film
equator	album
mama	film
ultramarine	color
revenue	album
conqueror	company
grant	contract
charlotte	film
deuteronomy	book
trainwreck	album
the_sword	film
philadelphia	magazine
pandaemonium	film
collar	ring
alfenz	river
agency	implementation
retrospective	work
chocolat	film
adjustment	change
fangs	album
kaash	film
mildenhall	town
oxford	town
cumberland_law_school	university
makrakomi	town
electrik	album
alcantara	river
amrapali	film
america	book
champ	album
dari	town
unst	island
sideshow	album
sommerkahl	river
lesbos	island
earl	album
goethe	novelist
aleocharinae	species
anastacia	album
chappie	film
slam	book
walden	album
allure	magazine
chives	herb
roofing	material
aasmaan	film
steele	person
versailles	film
dunn	town
shanghai	agent
ericka	album
navajo	film
adoption	film
archive	company
ecover	company
misterioso	album
pioneers	single
tianshan	town
shah	person
mixtec	language
nexity	company
citizenship	behavior
donuts	album
ascent	magazine
crackers	film
intersection	film
saga	album
india	person
tufts_college	university
mongrel	album
kannada	language
victoria_college	school
strawberry	album
uncut	magazine
provenance	episode
sophiatown	film
stranger	film
opsin	protein
livro	album
reconstruction	film
a.w.o.l.	film
butterfly	album
flight	film
hoogeveen	municipality
the_body	book
interleukin	cytokine
relic	book
argo	film
superclass	book
lovekiller	album
mmmbop	album
cuttlefish	species
carney	album
amelia	book
work	album
career	advancement
liza	film
jingzhe	film
amateur_radio	hobby
coloplast	company
heubach	river
larne	town
merc	work
remembrance	album
tristana	film
question	theme
onegin	film
welcome	film
bourbre	river
somebody	single
tutu	skirt
star	performer
birds	taxon
fantozzi	film
crawley	town
jealousy	film
tramway	film
tubuai	island
rusty	album
colony	film
christine	album
alinta	company
honeymoon	book
torchmark	company
timeline	album
winners	album
flesheater	film
trinity	painting
shelburne	town
tidings	album
champion	album
elder	species
saffron_walden	town
laozi	person
counterpunch	magazine
mariemont	school
rotation	movement
contest	book
emery	agent
harisu	album
grid	album
the_third_wave	film
epidemic	album
amstetten	municipality
abhayam	film
rest	death
ring	work
triangle	film
hamilton	lady
dust	film
volosovo	settlement
hairstyle	fashion
megatech	magazine
skorpios	island
the_silence	film
heat	race
catene	album
peshtigo	town
hellalive	album
exodus	episode
reis	person
alme	river
bird	film
cleveland	album
swiss	town
heartstrings	film
go-round	album
bliss	opera
lagan	river
slash	person
galician	language
quitting	film
fear	album
gamelabs	company
elaan	film
enemy	film
madhurey	film
cerberus	film
game	score
chaah	town
guraidhoo	island
fighting	film
chain	unit
litovel	town
iiyama	company
the_dream_academy	album
master	film
story	magazine
apus	constellation
gutu	district
photography	film
vereeniging	town
innocent_eyes	album
calidris	species
coyote	album
anjaam	film
rajdhani	film
flaunt	magazine
nannostomus	species
chandirani	film
sardinia	island
elpe	river
the_player	film
westcor	company
black	video
vincent	agent
survivor	book
shenandoah	film
castor	species
target	reference
slamnation	film
calvaire	film
the_gate	album
ulen	lake
gondwana	continent
offspring	film
fantasia	opus
humo	magazine
touloubre	river
elstar	cultivar
stereo	album
harper	film
open	album
oslava	river
the_passenger	film
lascars	film
running	operation
chirp	magazine
buttoners	film
prague	book
daydreams	film
estrone	estrogen
utopia	company
our_music	album
power	single
inhabit	album
tangram	album
essential	company
nissan	company
larkhall	town
utah_state	university
otso	icebreaker
wellington	town
expectations	album
sentinel	album
serena	film
oceanborn	album
the_mummy	film
damage	casualty
vandenberg	album
zoologist	biologist
guitarissimo	album
cando	river
shoes	album
khaleja	film
winchcombe	town
gymnomacquartia	species
the_names	book
scarp	island
walk	album
saranggola	film
siqueiros	painter
berry	town
iisc	university
pediment	gable
earth	stuff
bolus	pill
timeline	film
pollen	book
kentville	town
novorossiya	territory
unisys	company
stone_sour	album
adidas	company
changyou	album
boundaries	work
aflac	company
turbo	person
quotient	number
trip	experience
belong	album
aceto	album
absolute	album
madona	town
expansion	company
bloodletting	episode
kimberley	town
landfall	film
dena	company
wild_honey	album
the_key	work
chaparral	settlement
male	beast
arnold	athlete
afterlife	book
shopworn	film
amplified	album
new_york	book
riza	film
policeman	film
sarantaporos	river
premonition	film
crank	album
bazaar	store
sanyo	company
kankaria	lake
aera	magazine
fascination	album
wooler	town
prominence	importance
melisande	painting
galago	species
concordiasee	lake
ford	crossing
pirate_diary	book
volta	film
immunity	album
politics	activity
gaelic_football	sport
derichebourg	company
flesh	film
taipa	island
beowulf	film
prints	album
womb	film
all_the_time	album
book	section
ariba	company
nakanotorishima	island
sampling	measure
taxi	film
connections	album
tormented	film
brownies	film
adduction	movement
laborec	river
delhi-6	film
rawka	river
swamp	company
sign	album
watford	town
southwold	town
unit	special_forces
yale	agent
arroux	river
father	single
constellation	album
shadis	magazine
lincolnshire	county
schroders	company
clay	film
corona	light
ismail	athlete
nina	agent
pacer	album
allen	episode
waynesburg_college	university
boomerang	album
encuentro	album
creglingen	town
wollaston	chemist
activation	stimulation
slaughterhouse	film
nariman	film
ternoise	river
rapture_ruckus	album
junoon	film
hedda	film
gown	university
sanrio	company
omenuko	book
jackson	film
kwaidan	film
milladore	town
woodbury	economist
aakrosh	film
mirror	reflector
crosscurrent	album
mesentery	peritoneum
broye	river
padri	film
incomplete	album
gyantse	town
chromadex	company
segre	river
dospat	river
varshets	town
execution	book
remainder	number
spanglish	film
amanda	human
swanley	town
janina	album
radfordia	species
felon	film
nachalo	film
communion	album
karpenisi	town
journalist	magazine
the_man	album
return	episode
manning	town
compilations	work
laura	film
sparrows	album
catechism	book
galveston	town
coward	album
sweet	album
hizma	town
visual	company
aspirin	analgesic
permutation	album
kerplunk	album
escapology	album
material	equipment
time_warner	company
boards	magazine
funkadelic	album
beast	book
fuel	agent
devadasu	film
pipeline	single
awaargi	film
suze	bitters
vibratex	company
wanna	single
collateral	film
the_villain	film
junction	connection
brandywine_creek	river
karamay	film
victoria_college	university
confluence	company
fanmail	album
tribute	magazine
chondrite	meteorite
aconcagua	film
thing	entity
disciple	album
lafleche	town
numbering	list
brzostek	town
the_enemy	film
deceiver	film
heidi	book
baddiley	settlement
apparition	appearance
cyberman	film
bryant_college	university
scanbox	company
gravesend	film
metrocorp	company
cows	company
disintegration	album
paris	work
spring	company
sodexo	company
challenge	magazine
double_trouble	album
frostburn	book
godalming	town
sloop	sailboat
faye	person
aizpute	town
military	film
torquemada	grand_inquisitor
ilkley	town
dushman	film
videocracy	film
madirasi	film
condensate	album
conservatory	school
yagam	film
space	book
communion	denomination
wars	album
bibliography	list
cipher	algorithm
our_time	album
retail	marketing
thuthapuzha	river
corridor	album
officer	military_personnel
ciano	album
awam	film
zameer	film
baadal	film
amelia	film
cinemania	film
hobbit	film
betfair	company
kplang	language
slaughter	film
selena	person
the_great_day	film
gremlin	company
kemira	company
kaliningrad_oblast	exclave
ainge	book
ondine	film
feeler	album
sathya	film
wanfried	town
raavanan	film
mahaadev	film
skjern	town
movement	album
laramie	town
suggestion	proposal
aurora	company
occludin	protein
heartfelt	album
taxi	company
phaedra	album
cute	album
surfing	sport
calamus	species
success	album
coelus	species
bashaw	town
stain	album
amok	book
georges	book
imaginations	album
leirvatnet	lake
red_lights	film
bastard	color
tyria	river
noturus	species
husky	album
cork	person
dawlish	town
aiguillon	river
inhale	film
fiona	human
aryzta	company
senja	island
open	film
cybina	river
nakilat	company
nazism	fascism
tunicate	animal
wapella	town
holiday	single
environmentalism	preservation
hydra	work
exotica	album
coleoptera	species
delirium	film
insert	section
pulp	book
mojo	album
schoharie_creek	river
neil_armstrong	human
energy	album
lemmenjoki	river
shildon	town
chhalia	film
ascom	company
huragan	film
crossings	book
selby	town
nedlloyd	company
rodgau	town
lakhpat	town
damage	episode
tuck	company
outskirts	album
ghulam	film
lampedusa	island
ages	album
somnambulist	album
sicilian	language
duty	work
lumiton	company
yelp	company
netsky	album
tehzeeb	film
behringer	company
the_sisters_brothers	book
whispers	episode
deep_throat	film
zenith	film
mojo	magazine
kidulthood	film
il_divo	album
efco	company
kasos	island
adolf_hitler	person
strategic_studies	university
platter	album
mary	book
landmarks	album
ultra	film
infinity	film
cleveland	settlement
snark	species
trivium	album
oddcast	company
rain	river
allen	soldier
recoil	album
magrib	film
mimino	film
duet	opus
laura	painting
visitors	film
watusi	film
asylum	album
sekirei	anime
lugnut_studio	company
rems	river
quahog	clam
red_hat	company
cramlington	town
next	album
mycology	botany
pilkington	company
zarafa	film
viva	album
glatt	river
the_suicide_machines	album
pinocchio	film
polk_community_college	university
schaich	river
kaya	film
roadkill	album
birthday	album
file	company
reference	publication
hawkesbury	town
the_people	film
incognito	film
frontiers	company
momento	album
evita	album
danish	language
sunny	film
hotel	book
exmouth	town
raton	river
sall	river
rumors	album
vellum	book
deception	book
brunswick	town
miami	film
display	representation
flash	person
taiga	biome
kamen	town
palmasola	prison
julia	river
evangeline	film
atlantis	film
shower	film
subtraction	operation
estriol	estrogen
jungle	film
scarfies	film
mountains	album
fortum	company
mandragora	film
somersault	album
singoalla	film
hammer	person
lovechild	album
salaam	album
smedvig	company
norm	measure
rhumb	line
mercadona	company
daughter	agent
turnstiles	album
first_hawaiian_bank	company
loess	soil
complicated	album
kv54	tomb
glomma	river
states	album
automaton	machine
namumkin	film
hanesbrands	company
the_height	film
vivo	album
daugava	album
liebenau	town
echoes	work
pagli	film
fouga	company
wigger	river
treason	film
kinako	flour
axis	alignment
dolu	film
rayton	town
figure	impression
tips	company
however	work
northpower	company
threat	film
home_free	album
kermes	species
einbeck	town
breviceps	species
stryker	film
nure	river
bright	agent
mithunam	film
nanxiang	town
repe	river
wonderfool	album
result	work
isonzo	river
mahek	film
slon	album
schuyler	school
jazz	company
religion	work
lexus	company
enigma	work
diaz	person
ache	album
narrator	person
southam	town
story	fiction
der_kaiser_von_atlantis	opera
shine	single
hydrophobicity	property
pushkin	settlement
wrath	album
the_director	book
wetherby	film
shadrach	film
surakshaa	film
therasia	island
doomwatch	film
bliss	episode
nightcap	game
earthlings	album
comeback	single
monitronics	company
bacchus	painting
malo	company
live	film
peters	company
rauma	municipality
caudron	company
climber	robot
lucifer	light
wildfire	film
fleece	wool
bill	person
noss	island
stoughton	town
moskva	album
sydney	settlement
essent	company
bulbine	species
saint	book
concrete	film
breakdown	album
look	film
flint	river
bugged	album
virgin	film
mayday	album
airplane	album
thouet	river
nazi	agent
thune	river
the_castle	work
logic	philosophy
someone	single
trampoline	album
earth	film
spiders	album
black	chemist
shardik	book
wanderlust	film
telasi	company
liwiec	river
sympathy	album
youth	film
bliss	film
eisleben	town
mitchell	company
inkaar	film
colors	film
the_forest	book
mark	work
humber	estuary
dementia	film
post	communication
wutach	river
balalayka	film
racine	album
florian	film
monga	film
crankcase	housing
reform	magazine
barabbas	film
magnapop	album
cleveland	town
westbound	film
abdullah	film
swashbuckler	film
samsara	album
uromodulin	protein
lifesong	single
moskvityanin	magazine
vampyres	film
singam	film
dolores	album
arrangement	group
heimweh	film
broke	album
shale	sedimentary_rock
vitus	film
flexgen	company
brian_lara	person
bookmobile	library
the_state	company
qcue	company
seeker	missile
graft	album
achondrite	meteorite
aristotle	book
blade	superhero
candy	confection
chitram	film
recital	album
phase	appearance
nathan	human
aurora	telenovela
target	goal
california	single
compilations	album
possums	film
nazar	film
whistle	sign
carya	species
duns	town
the_codex	book
bulletproof	company
demonstration	protest
iole	species
tragus	river
nietzsche	philosopher
nuthe	river
lichen	species
animato	album
karki	exclave
alaria	species
promenade	album
mushtifund	school
dandupalya	film
clockwatchers	film
medianews_group	company
intoxication	film
watchers	book
ghar	film
ondas	album
computacenter	company
montage	album
georg	film
capellen	town
revolutions	album
charisma	film
mercedes	agent
lobby	people
chief	person
lasagna	album
animosity	album
ashfield	town
a_wonderful_world	album
nymph	film
saalfeld	town
vaudeville	album
section	company
acts	company
culture	work
dalton	agent
hybrid	album
octopus	album
milz	river
human_frailty	album
zschopau	river
guard	force
vilaine	river
veeraputhran	film
damart	company
sierra	agent
notorious	film
tracie	album
sabmiller	company
oker	river
turntable	album
singapore	film
restart	album
acronym	abbreviation
aldus	company
and1	company
masterpiece	painting
jamaican_patois	language
saline	river
therapy	album
faithful	book
statoil	company
pufnstuf	film
only_one_flo	album
the_three_degrees	album
revisited	album
kamaraj	film
ravenna	album
convergence	company
turbine	album
wicked	album
apparition	album
permanent	album
nova	book
red_dog	film
architecture	magazine
raaz	album
kaadu	film
vaygach	icebreaker
stages	album
reissue	work
3dlabs	company
bridge_creek	river
western	film
minstrel	performer
time_travel	album
motive	album
coccus	species
warpath	book
lavant	river
trabancos	river
cobra	agent
ochre	agent
chaos	work
bawtry	town
korczak	film
asia_media	company
transocean	company
motorcycle	work
siberiade	film
electronic	album
brownout	album
boston_state_college	university
koolhoven	company
temptation	album
benchmade	company
perry	town
mirabella	magazine
raja	album
topolovgrad	town
benna	lake
airship	aerostat
the_fear	film
reading	speaking
shadowlands	film
bb&t	company
wilbur	work
colleen	film
loomis	company
rambler	album
menace	threat
ocean	work
caterpillar	album
magister	company
maids	film
farmville	town
wizkids	company
disco	album
reporter	film
watusi	album
stretch	film
aversion	dislike
algol	binary
koream	magazine
utilization	activity
dick_tracy	film
fanfare	company
defector	album
churchbridge	town
periodontitis	disease
logica	company
diadem	headband
miles	company
daengbyeot	film
kiss	album
geyser	spring
sufi	muslim
lily	album
rotterdam	municipality
abhilasha	film
structo	magazine
fuck	work
retreat	film
dimitrovgrad	municipality
enmax	company
i.d.	album
edison	film
anjali	film
mandorock	album
wardleworth	settlement
kysuca	river
slalom	film
madhusudan	film
zimmer	company
worth	company
bamboo	company
artemisium	cape
spin	magazine
jewels	book
zachariah	film
solo	restaurant
kickball	sport
vicksburg	town
crossmaheart	film
bharya	film
asia	continent
my_man	film
demigod	album
arri	company
smog	company
jeep	company
mateo	person
prologue	album
newmarket	town
madman	film
marshallese	language
traveller	book
murphy	person
salamina	town
alatsee	lake
addiction	film
kanamachi	film
maattrraan	film
labussee	lake
rebus	film
magicians	film
bourbeuse	river
wetherby	town
phenomena	film
dionysos	album
corot	painter
shaw	settlement
gypsies	album
bilingual	album
aphrodite	album
apidae	species
compass_group	company
marco	person
woolwich	town
misa	river
intuition	album
the_bishop	book
alloy	material
carlos	album
fantastic	fiction
smiler	album
sciclyc	database
photograph	album
pinyon	pine
phasianus	species
steinbach	town
circus	single
kaplan	company
oxidase	enzyme
brigadoon	album
epsom	town
the_ball	film
westlock	town
kaadhal	film
mule	hybrid
the_original_soundtrack	album
witness	work
dender	river
beck	film
freaks	film
cleaner	film
campaign	race
forever	film
bedrooms	film
valentine	book
leben	album
reminiscence	memory
photo	single
tadcaster	town
tabu	film
valedictorian	university
players	agent
role	usefulness
noman	book
recordings	work
daybreak	film
zeta	magazine
playground	album
nikki	agent
equus	film
mentholatum	company
mother	agent
sikhism	religion
madrigal	work
december	film
countryman	album
mona_lisa	painting
bodyparts	album
getz/gilberto	album
pennsylvania	colony
telfort	company
centurion	company
togetherness	album
microsoft	company
matilda	film
dialogue	book
alan	person
time	record_label
albinism	disease
devdas	film
peterborough	town
kirby	agent
cherrybomb	film
triton	company
ancestor	book
taca	company
kineticglue	company
canthus	corner
crossroad	album
download	single
differential	difference
combination	sequence
destiny	magazine
logorama	film
roshni	album
fifth	rank
plan_b	album
fools	album
mausam	album
tubemogul	company
populace	people
appalachian	american
yantra	river
american_express	company
imprint	agent
rhodia	company
setswana	language
axiom	work
larix	species
animal	film
lift	work
exit	album
rauma	town
globe	model
atiu	island
hominid	species
hainan	island
elephant	company
freeze	album
powerglide	album
hole	opening
bodies	work
loxodonta	species
aitutaki	island
the_hand	film
arborfield	town
thief	single
buck	film
avant	album
westbury	company
taycheedah	town
asia_motors	company
shepherd	agent
transitions	book
jezero	lake
sempiternal	album
churchill	town
secure_computing	company
moskvitch	automobile
bullet	single
ronin	film
wellington	person
nemesis	book
rattlesnakes	album
mushishi	manga
hyoid	bone
obsolete	album
instinct	album
resurrection	revival
vaadhoo	island
liberty	magazine
graft	film
xianxia	town
rangali	island
stormbirds	album
replay	single
chunnakam	town
japan	settlement
well	work
m.sc	university
colon_cancer	disease
range	work
pennant	flag
elliott_smith	album
east	asia
the_answer	album
paris	single
blackenstein	film
impala	antelope
robot	company
bueninvento	album
advent	company
spectres	album
boren	lake
maasai	people
plunder	film
quay	restaurant
bridge	album
beloit	town
pure	book
bridge	company
fetishism	paraphilia
marathon_man	film
acceleration	change
akeldama	album
residence	house
pockets	album
scam	swindle
santos	athlete
dalton	chemist
monitor	display
dacii	film
qaidi	film
unit	work
confrontation	challenge
wingspan	magazine
vonda	town
nelly	film
manmadhudu	film
boogaloo	album
digger	machine
ensign	magazine
control_room	film
the_last_song	film
dusty	film
beek	municipality
franke	company
the_hot_rock	album
the_return	album
leahy	album
kerrobert	town
republican	advocate
jorma	album
kuolimo	lake
eider	company
anima	book
valediction	film
systemax	company
the_prophet	film
tragovi	album
mirrormask	film
busted	album
babakiueria	film
endless	single
bipolar	album
festival	album
touchpaper	album
northfield	town
tanggulashan	town
chaplin	film
swim	work
wildbird	magazine
koloss	album
pocahontas	film
the_edge	album
whitewash	film
sitter	river
pandora	album
alessi	company
deniliquin	town
recordings	album
brachytarsophrys	species
correios	company
endings	film
enough	single
eniac	computer
avion	company
paternity	film
greek	language
wildwood	book
converse	company
mehnatobod	town
framed	film
insult	film
koan	company
walden	book
damage	book
apollo	spacecraft
oscar	species
bastion	stronghold
hytera	company
waylon	album
warrant	film
path	line
tyagayya	film
bigdog	robot
agave	species
sectionals	episode
wayfarer	album
trail	path
duet	pair
the_bureau	agent
corona	town
allegiance	company
babel	confusion
atkins	company
ratos	company
recover	album
doomsday	book
erymanthos	river
soldier	worker
encore	film
relapse	album
colosseum	amphitheatre
collaborator	film
dixie	film
goodwood	town
nishana	film
himmatvar	film
twist	film
s.w.a.t.	film
columbia_bible_college	seminary
litavka	river
california	film
autografh	album
nice	single
roadshow	company
trucker	film
steinberg	cartoonist
longwave	film
orion	magazine
silence	single
marie	film
rivals	episode
conservancy	committee
cataract	album
the_net	album
page	book
sherlock_holmes	film
chaliyar	river
revolution_analytics	company
bedworth	town
addison	town
collections	work
tinkle	magazine
congo	river
beast	single
asura	film
rate	proportion
huanxi	town
challenge	film
steinbach	river
engineering_physics	university
callander	town
sant'antonino	municipality
madeleine	film
ifpi	sales
euterpe	muse
rameswaram	film
father	person
matinee	film
kerbdog	album
tiramisu	film
mystique	agent
failure	album
taksimo	settlement
salvador	book
store	depository
brotherhood	film
struggle	agent
mother	film
boomerang	film
the_meaning	album
mediatek	company
cowboys	agent
metals	album
flemish	language
new_york	colony
brigg	town
hanno	elephant
roosters	film
fairchild_semiconductor	company
underneath	album
unforgiven	film
linger	film
camouflage	book
diebold	company
regine	album
confusion	book
kiselina	album
orca	book
famine-33	film
albert	agent
professional_wrestling	sport
bislama	language
aurora	film
lovely	film
duluth	album
wohra	river
sunrider	company
high_art	film
gemalto	company
mousehunt	film
proper	company
claymore	anime
finger	digit
wyscout	company
english	language
brandweek	magazine
remington	rifle
broken	film
pontos	film
commandment	album
l'immortelle	film
arcadis	company
doll	single
destiny	single
boulevard	film
laudach	river
epicenter	book
rawtenstall	town
the_third_generation	film
spelter	zinc
navajo	athabaskan
vydra	river
birth	anime
god_bless_america	film
volkov	agent
heliox	mixture
constance	lake
impression	imprint
grief	work
terazije	square
buying	purchase
gendernauts	film
heligoland	album
force	influence
bednja	river
lech	river
ubiquity	company
eircom	company
the_lone_ranger	film
credits	list
rath	settlement
saint_vincent	island
cicheng	town
warhead	film
salticidae	species
locustella	species
jude	book
jail	film
dvdvideosoft	company
vertebrae	album
blasphemy	album
mishpacha	magazine
answers	album
armadillo	magazine
easygroup	company
the_producers	film
aphrica	album
sepia	color
cryptograms	album
rani_mraz	album
sonic_youth	album
niram	film
mirihi	island
circular	work
flodder	film
fandango	film
enel	company
dumplings	film
m.phil	university
yearning	film
zina	film
yield	album
secret	single
derrida	philosopher
revelation	album
bromide	halide
netherlands	language
dresden	film
warlock	film
beware	album
orlando	company
tomorrow	single
lory	parrot
birsig	river
station	film
satanis	film
fireflies	single
tempo	magazine
black	person
the_guardian	book
southwell	settlement
dakan	film
vertigo	company
bittorrent	company
barretos	municipality
navarathri	film
jambo	album
mod_fuck_explosion	film
ideascale	company
mortification	death
millionaire	work
footlights	film
vaali	film
meat	flesh
asia	album
maggots	album
bobby	agent
hinterrhein	river
metrorrhagia	bleeding
sterling	agent
awakenings	book
selbitz	river
landscaping	garden
doubt	film
cypress	conifer
iyarkai	film
kiss	single
jeremiah	book
gateway	film
passage	movement
nine	person
exai	album
nirvana	album
disposition	nature
veal	meat
sandbach	town
price	reward
imago	company
king	single
neighbors	album
millionaire	person
ninnes	hamlet
whispers	book
the_movies	album
ylivieska	town
sony_music_entertainment	subsidiary
lobata	species
tuscany	album
nekromantik	film
arranmore	island
ruda	island
chattahoochee	film
mushishi	anime
eidolon	album
saajan	film
continuum	company
georgica	film
martinlogan	company
asse	river
choiceodds	company
blade	runner
freefall	film
duet	episode
valaam	island
chase	film
zelig	film
overheard	film
rock	human
the_place	album
rangeela	film
sovereign	agent
tribe	work
housing	protection
chevrolet	company
mili	film
kumari	film
wickes	company
rebound	film
polymer	compound
sydle	company
fiction	literature
brothers	episode
physical_education	university
stronger	album
theogonia	album
warlock	episode
erbach	river
hiroshima	book
tiger	human
the_family	work
the_eagle	album
vytautas	person
infini	album
infogrames	company
tapas	film
singularity	album
boogie	album
draper	person
mysterium	album
escutcheon	plate
person	subject
walkden	town
the_message	work
dunstable	town
teisnach	river
maqbool	film
mortuary	film
circus	book
awake	film
argentina	river
bidaai	film
network	album
byrd	organist
prolepsis	album
towson_state_college	university
fjord	inlet
ludwig	film
bangasternus	species
jurm	film
bulgaria	species
araguaia	river
monograph	book
motivation	album
chester	town
lime	fruit
publication	printing
kasam	film
the_reaper	album
marvelous	film
exotico	album
staveley	town
psycho	film
comment	account
retiro	district
distillery	brewery
violator	album
otosclerosis	disease
continuum	episode
the_aftermath	film
bankstown	suburb
the_trip	film
infected	album
editorship	post
orion	spacecraft
bhutto	family
hawaiian	american
breath	single
speed	single
sparrows	film
plagiarism	album
natalie	film
hombres_g	album
brides	magazine
target	human
greenzo	episode
mozart	person
the_foundation	album
ource	river
work	painting
candida	species
wegener	geophysicist
impression	publication
liberator	album
belt	loop
hatya	film
uprising	album
video	single
thumb	finger
doina	film
wisdom	film
canvasback	duck
bawean	island
house	film
cueto	municipality
crises	album
mars	species
shikasta	book
vincent	film
chickasaw	indian
leyte	island
fugloy	island
lassen_college	university
plant	organism
graduation	university
river	album
twelve	film
skyway	film
execution	painting
cable	town
crackle	album
nasdaq	company
pccw	company
assault	film
the_life	album
chosen	book
australian	animal
liuqiao	town
legacy	book
touchdown	landing
phylocode	nomenclature
finesse	album
the_deceivers	film
no_escape	film
azeri	language
tupelo	town
worcester_academy	school
widower	person
gardish	album
insurance	protection
randy_newman	album
olney	town
harishchandra	film
the_mirror	album
tamia	album
chekavar	film
celebration	single
wordplay	album
my_friend	film
combinations	album
paperboys	film
jean	single
warpath	album
council	meeting
conatus	album
oudtshoorn	town
bryan	town
rotterdam	work
battle	agent
wasteland	book
breakthrough	film
galatas	town
amplification	increase
technigraphics	company
panhandle	film
bread	album
the_last_days	film
crazylegs	film
sawbridgeworth	town
odex	company
the_treasure	book
robert	human
error	failure
all_the_way	album
deftones	album
unplugged	episode
alarm	species
clips	person
liberty	freedom
apologia	album
l.i.e.	film
funadhoo	island
ohio	river
quay	pier
lovers	album
scutum	constellation
weissensee	lake
transit	film
gamers	album
enlightenment	album
eastwood	town
the_heartbreak_kid	film
prachatice	town
steinberg	company
ballads	album
uc_berkeley	university
suse	company
spirulina	species
saagar	film
cool	agent
champasak	town
iceland	company
elizabeth	settlement
essam	district
trace	album
lander	town
palenquero	language
commscope	company
change	clothing
artostan	album
ayer	settlement
symmetry	property
kauniainen	municipality
cousins	film
referral	case
aventurera	film
nepenthaceae	species
alatriste	film
detour	film
dwando	film
gone	single
bibleland	album
vodafone	company
climates	film
fimreite	battle
deterrence	film
telluride	compound
goha	film
paris	agent
brezno	town
anjaane	film
liquor	book
union	agent
pectin	cellulose
kayam	film
metso	company
trampoline	company
cypherpunk	activist
redeemer	album
lovelife	film
london	book
pastoral	book
pensacola	town
penthouse	film
bridge	connection
macau	microregion
bever	river
dementia	symptom
threshold	episode
stretch	person
the_lion_king	film
graceful	album
petworth	town
clermontia	species
nehemiah	book
alone	album
evangelion	album
binnenalster	lake
autoamerican	album
common_sense	book
buchen	town
maardu	town
sotho	language
phalaborwa	town
genshiken	manga
phenomena	album
hardtbach	river
oliva	species
kovil	film
gotham	magazine
nias	island
aqua	color
format	appearance
sadma	film
flanders	film
jaago	film
crossmark	company
lime	album
repulsion	force
fisons	company
ring	book
aide	officer
hell	book
anthrax	disease
baneservice	company
baturyn	town
newsquest	subsidiary
myoglobin	protein
felicity	agent
marshall	town
moulin_rouge	film
spellemann	album
mobitel	company
zana	human
fenlands	film
stark	album
loddon	town
mayotte	island
hughenden	town
flight	trip
melktert	dessert
explosion	increase
dolmen	megalith
michigan_state	university
vega	agent
pumaqucha	lake
my_sweet	film
diane	film
diana	statue
biomass	fuel
filitheyo	island
gamperaliya	film
fahrenheit	album
goitre	disease
hatchet	work
vlieland	island
nectar	drink
aquila	constellation
lipovo	settlement
plektrum	album
bianco	person
defiant	company
newt	film
ayres	album
volinaios	river
shuttle	film
bach	person
garden	single
bouygues	company
michelstadt	town
pinmonkey	album
the_book	album
cain	agent
satyam	film
the_information	book
caesium	metal
binary	album
transperth	ferry
juno	film
minerva	company
players	film
graduation	single
chickerell	town
inertia	company
lancaster	town
the_piano	film
saison	beer
mask	film
kanzi	bonobo
nell	film
da_baydestrian	album
muizenberg	town
natarang	film
b.sc	university
luciana	album
brave	single
cleckheaton	town
brightlingsea	town
accelerator	valve
caterham	town
shaker	album
the_jungle_book	film
fairport_convention	album
sinopharm	company
belovo	town
aschaff	river
honorary_degree	university
fleshcraft	album
kiske	album
fingers	album
the_remixes	album
ballers	album
legacy	work
revelation	person
smaragdina	species
telugu	language
loonie	dollar
barbie	film
moorland	habitat
pazhani	film
hofsee	lake
cuckfield	town
bioscope	film
suggestion	thought
avalancha	album
shiloh	film
soviet	council
messina	album
the_verdict	film
molong	town
arya	film
pinner	town
wordshaker	album
wishmaster	film
pitanga	album
zoroastrianism	monotheism
jargon	language
orocobre	company
greengage	plum
istina	album
the_egg	album
shakedown	film
fatal	album
captive	beast
airheads	film
mclean	town
strayed	film
magister	university
slurry	suspension
myrmelachista	species
long_john_silver	film
apple_inc.	company
parking	film
cynthia	species
richwood	town
cybage	company
murrays	company
fundin	lake
movieline	magazine
whitney	producer
the_trial	film
psychology	album
mobsters	film
trumpet	book
globe	sphere
daemon	film
cherry	species
malate	district
funplex	album
neumagen	river
slipknot	album
x264	encoder
bookies	film
fanagalo	language
atlantic	automobile
the_power	film
sakhi	film
birdwatchers	film
benjy	film
lingam	symbol
the_movie	album
amba	film
illusion	work
brahma	film
ellbogensee	lake
templeton	town
varalaru	film
bloxwich	town
turn	album
graduation	agent
fleurs	album
finisterre	album
abandon	film
w.a.r.	album
salvage	film
kulovesi	lake
pendle_college	university
giraltovce	town
behavior	trait
portfolio	agent
raft	book
erbach	town
pharmakon	film
insurrection	work
butterworth	settlement
hondo	film
tamil	dravidian
beast	agent
diwan	film
skopelos	town
driffield	town
flubber	album
idlewild	album
electron	lepton
bunte	magazine
ratatat	album
ruby	color
comerica	company
west_sussex	county
a.w.o.l.	album
mask	album
r._kelly	album
usaa	company
projector	album
strangefolk	album
gruiformes	taxon
junior	book
suit	appeal
michael	gorilla
barfly	film
mangareva	island
steek	company
protest	film
excursions	album
babenhausen	town
fast	abstinence
alster	river
turnabout	film
adoration	film
romblon	island
label	agent
amber	work
briksdalsbreen	glacier
washington	town
mathsoft	company
the_lost_world	film
rumors	film
smithville	album
purgatory	album
bostik	company
hbos	company
market	film
cebus	species
esquilache	film
the_alchemist	album
aashirwad	film
m.b.b.s.	university
southbound	album
hero	pinnace
moline	town
emte	company
forever	album
the_karelian_isthmus	album
betrayed	book
malo	island
profumo	album
mayavi	film
umut	film
skying	album
khiladi	film
douglas	town
brandy	album
anna	album
bones	book
demi	album
isorno	river
theme	work
the_criterion_collection	company
wardrobe	collection
flypast	magazine
earth	element
munna	film
appassionata	film
daybreak	episode
rojam	company
need	album
bathhouse_betty	album
princess	album
the_fury	film
stark	work
festival	film
keystone	album
konk	album
hamilton	town
jacuzzi	company
security	guard
piccarda	person
mahal	film
iisalmi	town
anthology	collection
flamingo	album
leptobrachium	species
mrlina	river
big_bang	album
sham	film
lost	book
raving	film
diana	film
indevr	company
outrage	film
heat	book
staircase	album
farnell	cocktail
handler	agent
escalator	album
s-94	film
cytherea	film
nelaug	lake
trip	album
cunnamulla	town
ambition	album
ruby	person
boxes	film
bakery	store
holiday	film
mutemath	album
sierra	company
inequality	difference
australia	single
emissaries	album
metacreations	company
loose	album
holy_cross_college	seminary
monotype	company
parma	river
freak	person
meridional	album
kuressaare	town
crna	river
the_heat	album
bleach	manga
rooster	album
goribor	album
boycott	film
kubrat	town
polegate	town
horseplay	film
michael	episode
drive	work
ladykillers	film
enclosure	album
mojave	album
matter	entity
alcibiades	person
kozara	film
bharathi	film
behavior	activity
blackall	town
nauker	film
carnot	physicist
endurance	strength
chemnitz	river
dimovo	town
crescendo	film
giglio	island
whity	film
monster	episode
scale	proportion
flicka	film
byron	town
accommodation	assistance
quick	area
commentary	genre
sirk'i	mountain
slipper	shoe
scientific	organization
sheriff	official
indie_rock	genre
new_museum	contemporary_art
neruda	poet
miracle	event
composition	creation
realism	genre
afrikaans	dutch
balloo	townland
seoul	capital
nicholson_street	road
presentation	event
sauce	recipe
boiling	vaporization
encouragement	hope
behrens	architect
form	attribute
edutainment	entertainment
guest	client
columbia	genre
documentary	picture
klopstock	poet
king_street	road
cake	pastry
debt	obligation
the_jerusalem_post	newspaper
optimism	hope
copyright	organisation
battery	organization
swansea	port
business	concern
position	profession
waffle	cake
arena	environment
cascade	organization
boat	organization
high	organisation
tractor	organisation
chrysalis	organization
cyberpunk	genre
m-217	road
wuffingas	dynasty
nicole	organization
knowledge	organisation
clarinetist	musician
foie_gras	food
thessaloniki	port
blake	poet
apostle	christian
nobody	user
pillar	form
control	organisation
zimbabwe	republic
espadrille	shoe
convertible	auto
virtuoso	musician
girls	organisation
attitudes	organization
soloist	musician
isis	organisation
amos	prophet
m-150	road
uusimaa	newspaper
rover	product
great_eastern_highway	road
iremel	mountain
vitamin	nutrition
lausanne	capital
yeroo	newspaper
avalanche	organization
ambassador	diplomat
player	soul
kiowa	tanoan
waterproof	fabric
svoboda	newspaper
missoulian	newspaper
head	individual
navigator	organization
player	organisation
rise	travel
bulkhead	partition
angel	sculpture
divine	organisation
straw	tube
alvand	mountain
the_party	organization
longhorn	organization
seat	mountain
autumn	organization
bellavista	mountain
santo_domingo	capital
suite	apartment
lincoln	organization
revenge	organization
nippletop	mountain
goaltender	position
perfect	organization
amsterdam	capital
austria	organisation
cbc.ca	news
wizards	organization
road	infrastructure
marina	port
soul	mind
argument	discourse
justice	official
armand	vampire
balance	organization
high	level
the_spotlight	newspaper
kralendijk	capital
shimla	capital
7days	newspaper
gyeryongsan	mountain
lofoten	archipelago
paper	medium
troubadour	poet
caesar	comedian
mecc	organization
general	fact
gambling	entertainment
fovea	area
mangart	mountain
pesto	sauce
base	bottom
reddit	website
ammunition	arms
sauce	condiment
battery	organisation
august	organization
crown	peak
construction	event
kampala	capital
rumija	mountain
nantucket	organization
m-134	road
citizen	organization
north	newspaper
assemblyman	representative
ambassador	organization
dawn	sculpture
eaves	overhang
storksbill	geranium
leader	soul
creation	organisation
bachata	genre
chalga	genre
electro	genre
counsel	lawyer
copyright	intellectual_property
national	brand
user	organisation
unabridged	dictionary
finch	organization
socialism	ideology
rm-38	mortar
shaadi.com	website
bc_place	stadium
renault	s.a.
germany	republic
highway	road
valley	landform
harmony	music
gwadar	port
bucharest	capital
lemma	proposition
cherokee	iroquois
banner	poster
baidu	website
riverside_drive	road
chapter	organisation
yogacara	mahayana_buddhism
baking	cooking
the_association	organisation
scientist	profession
hypoplasia	dysplasia
alexander	community
partnership	organization
auto	organisation
cheeseburger	hamburger
hentai	genre
vtol	aircraft
being	organization
performance	event
west	organization
port	side
egypt	organisation
stern	organization
temperature	composition
guide	leader
m-10	road
lakeside	organization
ergo	newspaper
charm	flavor
bucs	organisation
koch	organization
lawyer	jurist
solid	form
stabile	sculpture
beirut	capital
volleyball	organization
m-25	road
matron	nurse
isis	organization
conflict	organization
tracer	ammunition
evil	event
express	shipping
dubai	organization
love	music
central	organization
one57	skyscraper
west	organisation
satire	genre
hobart	port
staufen	mountain
doubloon	coin
cave	landscape
bust	sculpture
volovec	mountain
lincoln	capital
baron	lord
phoenix	whaler
seraph	angel
taymyr	newspaper
samoan	polynesian
control	standard
thisday	newspaper
talisman	object
blake	organization
30_st_mary_axe	skyscraper
scribd	website
citizen	organisation
the_alabama_baptist	newspaper
septum	partition
postmaster	position
films	organization
stock	support
high	organization
aids	immunodeficiency
novelty	genre
pumasillu	mountain
marathon	footrace
knowledge	organization
bellevue	plantation
grossglockner	mountain
ligue	organization
succubus	demon
the_daily_mirror	newspaper
plaid	fabric
retired	organization
viscount	lord
shadow	organisation
podcasts	genre
dynasty	organization
chinook	newspaper
anonymous	organization
gazetteer	dictionary
streetpunk	genre
rise	grade
bottom	side
harvey	scientist
barth	theologian
falcon	aircraft
bratislava	capital
menheniot	village
anthem	song
namur	place
rochelle	city
fono	band
genius	song
wortwell	village
ridgmont	village
muthill	village
tuscaloosa	city
horton	village
dicycle	vehicle
bayendar	village
ccr5	gene
harris	place
kelston	village
graphite	coal
deadline	band
bon_jovi	band
saree	dress
building	structure
meyaneh	village
hallsburg	city
offenburg	city
weinheim	city
absolution	band
norman	soprano
cymru	place
sheykhlar	village
jamestown	city
amherst	city
barlborough	village
heraclea	place
focus	encyclopedia
rostamabad	village
civita	frazione
stevie	play
catron	city
fanfreluche	horse
ponta_delgada	city
palmetto	city
beighton	village
annaba	city
generator	engine
kharkiv	city
richmond	city
hryniewicze	village
quote	excerpt
davos	place
willis	city
henan	place
blacklock	horse
nadja	band
macomb	city
mohammadabad	city
morden	city
taylor	city
hutto	city
assemblage	system
whitby	city
xuetian	village
eagle	ship
cheselbourne	village
hercules	city
zoroaster	band
aeon	band
sniper	band
hovercraft	vehicle
wellow	village
border	boundary
lights	artist
zabol	city
lahu	village
thambiluvil	village
arkona	band
soprano	singer
richard	artist
bronson	city
bayes	mathematician
fushazdeh	village
crack	defect
chariot	carriage
buurmalsen	village
nimrod	city
silverton	city
quimper	city
ginger	band
drymen	village
escuintla	city
riverside	city
mogador	place
polebrook	village
salme	village
bytom	city
blenheim	horse
overton	village
the_rounders	band
bloch	composer
guns	band
sort	similarity
brvenik	village
exeter	ship
gwehelog	village
evidence	indication
altan	band
cordeliers	club
chippewa	place
hamidabad	village
logan	band
turpan	oasis
evelyn_waugh	writer
3oh!3	band
elissa	ship
hellsongs	band
spencer	village
temecula	city
wray	city
biri	village
foundation	relation
wyoming	city
petersburg	place
snook	city
eclipse	device
john_xxiii	pope
maisemore	village
astarte	deity
elektra	band
hamngatan	street
kopy	village
reset	band
denison	place
qingdao	city
portesham	village
boundary	extremity
madrid	band
matthews	city
xianfeng	village
point	city
lehi	city
witch	band
kooks	song
sale	occasion
ruston	city
pickerington	city
genius	talent
oasis	song
lhcb	experiment
robbery	theft
hollinwood	village
montrose	city
kothali	village
coquille	city
ougenweide	band
monticello	typeface
arbovirus	band
ironwood	city
zachary	city
aeris	airline
okinawa	city
oktyabrsky	city
transylvania	part
feldberg	band
familiar	friend
costume	dress
dimension	concept
air_koryo	airline
velvet	song
drumaness	village
lasem	village
termunten	village
marianivka	village
thurne	village
eybakabad	village
welsh	country
canjet	airline
jaberi	village
dargah	village
karmal	place
bellville	city
klee	band
midwest	place
aharoni	typeface
incident	occurrence
buckminster	village
powerhouse	team
methadones	band
kreuzkirche	church
tallis	composer
lidu	village
noonday	city
regret	emotion
oberkochen	city
donaldson	city
rhynie	village
barbaresco	wine
wing	portion
arianism	heresy
chavassery	village
reunion	song
mianeh	village
this_town	song
belses	village
partsi	village
karma	fate
laguardia	place
yashin	band
huntsville	place
headlam	village
kosman	village
nasum	band
qahrabad	village
loudermilk	band
pass	throw
breaza	village
owensboro	city
stavropol	city
shuangle	village
butte	city
tamtam	village
helplessness	depression
july	month
hubin	village
taxonomy	hierarchy
mushroom	song
aline	band
milan	city
burt	city
ipstones	village
johnston	place
potamoi	village
hume	city
abbey	monastery
lamitan	city
ignition	band
caterwaul	band
milford	village
babymetal	band
oakley	village
slaugham	village
dukes	band
anacortes	city
the_project	band
beta	letter
papua	part
selce	village
noble	horse
wire	band
stupa	shrine
geneva	city
supporter	band
rendham	village
texas	place
tcf4	gene
yablonovka	village
zacatecas	place
selja	village
bahram	horse
aude	village
effingham	village
paxton	city
inability	quality
vintage	band
thrice	band
halton	village
galva	city
fladbury	village
athalie	play
castlewellan	village
aasu	village
sadberge	village
pudding	dish
auferstehungskirche	church
chancery	court
vacuum	part
farrell	writer
ancient	band
maguiresbridge	village
salehabad	village
waltham	city
orillia	city
merrick	place
bucklin	city
ameriyeh	village
belinda	ship
burham	village
tarleton	village
bubel	band
epsilon	letter
departure	song
weapon	device
thurii	place
salisbury	city
westlife	band
leningrad	place
tunic	cloak
tame	song
painkiller	band
toffee	confectionery
valik	village
pool	water
indus	country
misawa	city
venezuelan	place
flamborough	village
xombie	band
bledington	village
lion_air	airline
mexicana	ship
penryn	place
timmins	city
transbrasil	airline
dreadnaut	band
farwell	city
djibouti	country
tuddenham	village
jackson_heights	city
cranleigh	village
hinterland	band
l'austral	ship
penselwood	village
attraction	quality
ascender	letter
sixth_avenue	place
malin	village
koszalin	city
the_hook	place
nabokov	writer
broomfield	city
tract	system
longcot	village
israel	kingdom
degen	village
ayrshire	place
fergana	city
lali	city
dommin	band
paul_smith	artist
acre	city
soviets	place
inverkip	village
san_pedro	city
classifier	morpheme
treorchy	village
aman	place
horningsham	village
breeding	production
hawnby	village
fate	city
beat	band
serengeti	region
arkansas	song
cosmos	flower
markethill	village
agdistis	deity
vratsa	city
zhejiang	place
oldenburg	place
triple	artist
praise	worship
battles	band
livada	village
brugge	city
tradition	practice
norway	city
border	edge
sahara	song
findlay	city
salir	village
ricin	toxin
muskego	city
longthorpe	village
manzar	village
bull	center
denton	village
godsmack	band
bowling_green	city
northeast	direction
derk	village
balfron	village
the_bells	song
katyusha	song
dover	place
dial	band
coppell	city
madisonville	city
translation	place
mallapur	village
mecha	vehicle
annie	band
adolfo	city
signature	name
gute	village
aerolift	airline
colorado	song
dobrzyniewo	village
aiken	writer
paradise_lost	band
harbridge	village
ioanella	frazione
kashmir	place
shepherdswell	village
gujarati	sanskrit
metric	function
hindus	country
tributaries	country
tourniquet	band
clemens	writer
linden	village
talladega	city
bijela	village
the_bells	band
kivisili	village
moab	city
salla	village
opole	city
castle	building
oregon	place
solomon	village
torrens	ship
vildanden	airline
bahaabad	village
palmer	city
gore	blood
buchlyvie	village
peking	ship
court	place
passion	artist
economy	system
vladivostok_air	airline
escalante	city
yokohama	city
annihilator	band
georgia	typeface
gilsland	village
ulysses	song
kobe	city
ramsey	city
insurgency	rebellion
seattle	city
taleshan	village
zargar	village
navarone	band
whole	concept
plummer	city
dominion	band
debrecen	city
carmine	city
neap	village
chickenpox	band
carp	freshwater_fish
part	assets
suede	leather
npc1	gene
name	repute
gladstone	city
brill	village
kade	place
jinja	city
myopia	band
dancing_brave	horse
gach	village
saosin	band
empyrium	band
reunion	place
lackawanna	city
solger	band
the_monsoon_bassoon	band
norg	village
raleigh	place
horbury	village
putu	village
griffith	city
churchyard	cemetery
belarus	country
vallejo	city
swirl	band
mika	artist
ukiah	city
lostalone	band
arsenal	band
letter	grapheme
tuil	village
brain	organ
tonic	band
requiem	typeface
bonding	technique
upperthong	village
angus	place
heartbreak	band
burrito	dish
burnley	place
brandiston	village
tongham	village
kopice	village
belgium	village
malinau	airport
dehnowvan	village
ynysybwl	village
hannibal	city
haynes	village
zachlorou	village
arouet	writer
separation	state
kampanis	village
maia	village
treklyano	village
lelu	village
the_gap	place
rugby	place
occasion	reason
mona	city
aberdeen	song
shuangquan	village
rumia	city
billystick	club
stanwell	village
call	visit
rona	village
rockville	city
daleth	letter
riverdale	city
horning	village
jabara	village
precision_air	airline
applause	song
mechanical_engineering	technology
angarrack	village
londesborough	village
pomona	city
dole	village
st._michael	city
dalian	city
poteet	city
eendracht	ship
serbs	place
kazzia	horse
owen	industrialist
lapush	band
pax3	gene
porch	structure
betley	village
egyptologist	orientalist
edlesborough	village
rudston	village
wave	weather
dogs	band
markfield	village
providence	city
spaceship	song
newburgh	village
ussuriysk	city
dumpstaphunk	band
titanium	band
sunline	horse
detector	device
wallonia	region
atrocity	band
makkinga	village
eden	village
lemuria	band
pekanbaru	city
landslide	victory
corpus_christi	city
destroyer	warship
translation	transformation
shrewsbury	city
holton	city
half_moon_bay	place
counselor	consultant
mendelssohn	composer
sinclair	writer
oceana	band
sultanate	country
colina	village
dodworth	village
cockiness	song
burnett	writer
scarville	city
revocation	place
mayflower	city
distraint	seizure
wauzeka	village
term	concept
cockington	village
schwerin	city
godshill	village
holmewood	village
galunggung	stratovolcano
armeni	village
trapt	band
tabasco	state
sasha	band
diver	swimmer
zurich	city
allstars	band
mandola	mandolin
grace	ship
lipnik	village
substance	part
arnol	village
collieston	village
oceano	band
broomfleet	village
durisdeer	village
hawkins	city
rietavas	city
ricochet	band
tonga	country
stagecoach	band
odense	city
asperen	village
caribbean	country
binghamton	city
middle	point
barcarole	song
herriard	village
somapur	village
kjosfossen	waterfall
fenton	city
taleqan	village
article	prose
helford	village
spectrum	song
foley	city
hills	city
bykovo	airport
custer	city
elmesthorpe	village
camblesforth	village
cuba	city
atomic	band
ewden	village
valdez	city
dominion	country
newenden	village
arlyn	band
owen	village
mechelen	city
tiptoe	song
proxies	band
woodleigh	village
titani	village
leeton	city
cheng	place
hercules	place
elmdon	village
onirama	band
horsell	village
jacksboro	city
inversija	airline
eathorpe	village
hatfield	city
roland	city
heqing	village
winning	song
nelson	city
hulcote	village
nebraska	song
wakefield	city
preposition	place
kanawha	city
ponikve	village
shamokin	city
buttercrambe	village
oregon	village
paja	village
engine	band
acequia	city
forst	city
hardham	village
hixton	village
huizen	village
paragon	artist
murchison	village
nagpur	city
theatre	building
tafresh	city
bulldog	band
hamm	place
jahanabad	village
memphis	place
prachovice	village
klinja	village
crossbow	weapon
mckittrick	city
manvel	city
croglin	village
karlstad	city
bavan	village
evergreen	city
afula	city
amory	city
langstone	village
korukonda	village
carroll	writer
polly	song
a*teens	band
aquarium	band
irin	village
penguin_group	publisher
roxas	city
vijlen	village
eisbrecher	band
comune	place
high_hopes	song
bywell	village
mosna	village
muker	village
problem	song
boundary	extent
groomsport	village
chelvan	village
detective	band
ravand	village
abercrombie	village
yazdgerd	village
annandale	place
hungarians	country
brockenhurst	village
hareh	village
stereopony	band
hearne	city
milton	city
somoni	currency
gouda	cheese
skyservice	airline
nana	village
khalilabad	city
peso	currency
eastborough	city
mainland_china	country
ball	artist
orfevre	horse
fade	band
wainwright	city
ugandan	country
akron	city
polotsk	city
marysville	city
kifteh	village
fuchsia	bush
legnica	city
trusley	village
newcastle	village
kidlington	village
debenham	village
bothal	village
hellfire	song
rockford	city
palace	building
murayama	place
elkton	city
lucerne	place
shoreacres	city
crosshouse	village
dadivank	monastery
harrisville	city
coahuila	state
littleton	city
famicom	device
camp	gene
teague	city
cowl	hood
hermit	horse
doulting	village
fuman	city
vibe	band
idaho	ship
ogema	city
almere	city
fontaine	fountain
faxi	waterfall
aachen	city
zofianka	village
port_macquarie	city
moreno_valley	city
shahabi	village
seychelles	state
kenedy	city
dalasi	currency
pearl_harbor	place
benton	city
callejeros	band
abundantius	name
jelcza	village
pata	village
tower	structure
zabrze	city
meld	horse
play	action
victor	city
harbledown	village
fireside	band
bobbing	village
rhydyfelin	village
fishbone	band
rosedale	place
merlo	place
belgium	federation
niedrzwica	village
hormone	secretion
placencia	village
ognissanti	church
catfish	song
burden	band
machina	band
wattstown	village
ochten	village
kinetoscope	device
zatouna	village
index	directory
atherton	place
langham	village
fittleworth	village
shalvar	village
hale	city
rotc	corps
hatfield	village
mutyh	gene
taplow	village
decatur	city
rupture	trauma
satie	composer
corral	place
ballygawley	village
mission	olive
bayport	city
throw	play
croyde	village
ataraxia	band
gilford	village
cessnock	city
goldsmith	city
clarens	village
cumberland	city
perfection	state
newsome	village
bomb	weapon
catherine_howard	queen
eulogies	band
claflin	city
carignan	grape
johanniskirche	church
mana	village
glengarnock	village
tyre	city
lied	song
bassett	city
stavrodromi	village
swainby	village
nuclear_power	electricity
gilmer	city
braidwood	city
adagio	band
beaumont	place
bonehead	band
a_long_walk	song
feniscowles	village
ajgaon	village
earlington	city
kaynardzha	village
newsted	band
heel	part
glassford	village
onion	bulb
sireniki	village
qaranqu	village
sibley	city
reel_big_fish	band
limpsfield	village
lithium-7	isotope
harrington	place
pune	city
costa_rica	place
ceylon	country
priboj	village
britton	city
fiasco	band
rio_de_janeiro	city
confessor	priest
dallas	village
tangerine_dream	band
heythrop	village
elsmore	city
theophany	manifestation
poland	village
muscat	region
sunair	airline
augusta	ship
almondbank	village
farrell	soprano
navenby	village
boyd	village
front	place
bell	typeface
midas	band
eustis	city
night	play
the_raincoats	band
programme	system
tighnabruaich	village
seldovia	city
feature	article
st._johns	city
avatar	band
reciprocity	relation
cornflour	starch
nadir	place
nurabad	village
subsonica	band
northerly	horse
triangle_sun	band
summerset	city
the_world	song
dishwalla	band
vale	city
coil	structure
moira	village
radiology	imaging
mahmudvand	village
wickwar	village
kate	band
beighton	place
navesti	village
wampanoag	place
women	band
tracker	band
dendermonde	city
lenfilm	corporation
naimabad	village
dunhampstead	village
kniveton	village
nelson	village
goliath	warrior
beckley	city
mainland	country
hoseynabad	village
sileby	village
paradise	city
natoma	city
colossae	city
braniff	airline
durak	village
holland	region
ruse	city
amiens	city
stanningfield	village
ryukyuan	japanese
inferno	song
nutshell	song
mattapoisett	place
sutherland	soprano
port_arthur	city
sports	broadcaster
new_jersey	region
killinghall	village
gretna	city
dominica	country
gayhurst	village
taxman	song
kalejak	village
nottingham	city
esther	play
buddhists	country
hale	band
center	point
karma	band
wortley	village
equatorial_guinea	country
trefaldighetskyrkan	church
katsu	artist
poole	village
hinxton	village
yarkhill	village
samaria	city
wilmette	village
pernik	city
inferno	horse
romania	country
razorlight	band
makaravank	monastery
puno	city
papua_new_guinea	place
astara	city
bastrop	city
region	place
fate	song
seabrook	city
newton	city
wass	village
risotto	dish
sunfish	freshwater_fish
hawley	place
solway	city
move	play
emperor	band
vessels	band
leominster	city
manor	place
eversholt	village
mileham	village
praia	place
bacton	village
yardley	place
annie	artist
roughton	village
thurgarton	village
serres	city
superfamily	band
zohan	village
fewston	village
camarillo	city
depression	sadness
holland	place
miskin	village
porch	song
haughley	village
doftana	village
cash	currency
nion	letter
vast	band
eastergate	village
poetry	style
coleraine	city
saint_paul	city
renminbi	currency
robins	city
play	vice
shawsville	place
f.l.y.	band
evershot	village
defoe	writer
soviet_union	place
beeston	village
redbrook	village
leningrad	band
sameleh	village
modulation	transmission
tchaikovsky	composer
mount_vernon	city
grayson	city
bago	horse
blackfire	band
beginner	band
pidavoor	village
qasemabad	village
shirabad	village
farmersville	city
bornite	mineral
burton	ship
caucasus	place
tubu	village
owen	band
tony	village
manitoba	place
pinu	village
drenovac	village
anticipation	song
cynthiana	city
bogor	city
ablaut	vowel
strangers	song
kerion	band
minton	village
hugoton	city
quadriga	award
crofton	city
brockton	city
noonu	village
mutiny	revolt
eritrea	state
serenade	song
rubicon	band
waltham	place
mayfield	city
franklin	city
tapani	village
moment	point
casserole	dish
gorban	village
electricity	song
wrinehill	village
lightning	clipper
devo	band
4chan	imageboard
grendel	band
bere	village
newtownstewart	village
lofou	village
martin	airliner
woonsocket	city
manhattan	song
st_katharine_cree	church
waldo	village
sulin	village
gholamali	village
nicolson	writer
inwood	place
amaranthe	band
farm	dwelling
fairies	band
leona	city
basement	place
band	village
svaneti	region
biographer	writer
colonel	artist
draperstown	village
mudmen	song
benton	village
ransomware	malware
karelia	band
sadler	city
dallas	band
madron	village
hillsboro	city
ahmadabad	city
flower	band
poundbury	village
anglicans	place
ousefleet	village
palatine	place
serial	series
ashperton	village
marlborough	ship
edgworth	village
lynmouth	village
icelandair	airline
ozark	place
tuapse	city
middelburg	place
seville	place
horspath	village
ruthless	horse
kukav	village
pana	city
sonicflood	band
raleigh	city
herriman	city
burden	weight
victor	ship
kurichithanam	village
djibouti	city
truth	band
crow	band
neoclassicism	arts
taroona	place
trikorfo	village
device	style
contentment	happiness
defiance	band
hartland	village
dealu	village
quantum	software
boyd	ship
mohammadabad	village
verdun	place
harbottle	village
stardust	band
session	band
plane	village
owdeh	village
louvre	building
belgium	country
59th	division
hyland	band
quernmore	village
sting	pain
pulloxhill	village
nino	band
kalhor	village
furnace	village
ahmadabad	village
saracen	band
depth	part
sporcle	quiz
saltfleetby	village
clawfinger	band
lagkadia	village
granit	village
new_albany	city
hydrabad	ship
invermay	village
bold_forbes	horse
damems	village
craigellachie	village
edathirinji	village
club	band
wilmot	city
turku	place
hobson	city
nishinomiya	city
microsoft_windows	software
starlight	song
spofford	city
medea	ship
stance	village
malmo	place
lakhiganj	village
kittie	band
dion	artist
johnston	typeface
northeast	place
young_love	band
machrihanish	village
murder	crime
opava	city
grillenburg	castle
danko_jones	band
varietal	wine
term	point
barrow	village
retsina	wine
koprivnica	village
shere	village
engels	city
kimball	city
golberdon	village
gran	place
southill	village
colt	carbine
denbury	village
owriyeh	village
simultaneum	church
funchal	city
angostura	bark
daizystripper	band
winterburn	village
embryo	band
richard_ii	play
henham	village
engine	artist
women	song
oceanside	city
buddy	band
viborg	city
kalan	village
harrington	city
canterbury	band
stanley	city
cordero	city
wounded	song
oxenholme	village
middle	part
stubbs	historian
sichuan	place
yakuza	gangster
allocation	part
bryson	city
eden	city
destruction	state
chernytsia	village
maru	village
air_france	airline
equilibrium	band
bulmer	typeface
evanston	city
baldersby	village
toledo	village
moment	present
beverly_hills	city
banks	village
narrows	band
new_castle	city
atworth	village
the_moody_blues	band
cocker	spaniel
difficulty	quality
city	neighbourhood
blackberry	device
vampires	song
fethiye	city
trincomalee	city
point	part
shahabad	village
pydna	place
eminence	city
eastminster	ship
sari	city
samaria	place
tamil_nadu	place
tasmania	place
move	song
erpingham	village
mitford	writer
equity	assets
peshawar	city
bebot	song
manis	orangutan
pius_xii	pope
belvedere	band
brigstock	village
edge	boundary
zatom	village
portola	city
wingham	village
whitebridge	village
zarko	village
st_asaph	city
hossur	village
volcano	band
buraki	village
eclipse	horse
potlogeni	village
tulyar	horse
tekoa	city
st._john	city
tyranny	band
dent	village
watertown	city
dunsmuir	city
neatishead	village
m.khanapur	village
poulaphouca	reservoir
gender	band
challenger	comics
shankill	place
naga	city
vereinsthaler	currency
bruch	composer
pulley	band
netherthong	village
